xxxxxxxxxxxxxxxxxxxxxxxxxxxxxxxxxxxxxxxxxxx
x            x               x            x
x            x               x            x
xxxxxxxxx    x  xxxxxxxxxxxxxx            x
x                                         x
x                                         x
x            x               x            x
xxxx    xxxxxx               x            x
x            xxxxxxx      xxxx            x
x            x               xxxxxxxx    xx
x            x               x            x
x            xxxxxxxxxxxxxxxxx            x
x            x               x            x
x            x               x            x
x            x               x            x
x            xxxxxxx      xxxx            x
x            x               x            x
x                            x            x
x                            x            x
xxxxxxxxxxxxxxxxxxxxxxxxxxxxxxxxxxxxxxxxxxx